Alil=Avril
Mi=Rémi le réveil
Pati=Parti
Élaaaa=Il/elle est là
Lolo=De l'eau ou Lolo le singe
Mini=Fini
Peupé=S'il te plaît
Dote=D'autre/encore
Pateur=Aspirateur
Coudile=Crocodile
Poulouloule=Poule qui roule
Pabo=Bravo    
Pout=Prout
Goude=Gourde
Pin=Lapin
Couli=Borocoli
Tadi=Interdit
Coké=Perroquet
Daaaooo=Là-haut
Potote=Compote
Padon=Pardon
Nanille=Vanille  
Poupi=Tchoupi
Cola=Chocolat
Boupin=Bout de pain
Babar=Je veux voir
Copokan=Toboggan
Poulelle=Poubelle
Moumi=Fourmi
Oupi=Youpi
Etal=De l'aide
Patolé=Pâte à modeler